COL title VAL converting relational to object-oriented databases COL authors VAL j fong COL venue VAL sigmod record COL year VAL 1997	COL title VAL multidimensional version for object-oriented databases COL authors VAL e sciore COL venue VAL proceedings vldb , COL year VAL nan	0
COL title VAL extraction of object-oriented structures from existing relational databases COL authors VAL s ramanathan , j hodges COL venue VAL sigmod record COL year VAL 1997	COL title VAL integrating a structured-text retrievalsystemwithanobject-oriented databasesystem COL authors VAL tw yan , j annevelink COL venue VAL proc 20th int conf on very large databases , santiago , chile , COL year VAL nan	0
COL title VAL database management systems and the internet COL authors VAL s malaika COL venue VAL vldb COL year VAL 1996	COL title VAL data grid management systems COL authors VAL a jagatheesan , a rajasekar COL venue VAL nan COL year VAL nan	0
COL title VAL optimizing the secure evaluation of twig queries COL authors VAL s cho , s amer-yahia , l lakshmanan , d srivastava COL venue VAL vldb COL year VAL 2002	COL title VAL optimization of query evaluation algorithms COL authors VAL sb yao COL venue VAL acm transactions on database systems , COL year VAL 1979.0	0
COL title VAL an effective hash based algorithm for mining association rules COL authors VAL j park , m chen , p yu COL venue VAL sigmod conference COL year VAL 1995	COL title VAL an effective boolean algorithm for mining association rules in large databases COL authors VAL sy wur , y leu COL venue VAL nan COL year VAL nan	0
COL title VAL the ores temporal database management system COL authors VAL b theodoulidis , a ait-braham , g andrianopoulos , j chaudhary , g karvelis , s sou COL venue VAL sigmod conference COL year VAL 1994	COL title VAL performance evaluation of a temporal database management system COL authors VAL r snodgrass COL venue VAL proc . acm sigmod , conf management of data , may , COL year VAL nan	0
COL title VAL automated resolution of semantic heterogeneity in multidatabases COL authors VAL m bright , a hurson , s pakzad COL venue VAL acm trans . database syst . COL year VAL 1994	COL title VAL automated resolution of semantic heterogeneity in multi-databases COL authors VAL ar huroson , s pakzad COL venue VAL acm transactions on database systems , COL year VAL nan	1
COL title VAL guest editorial COL authors VAL nan COL venue VAL nan COL year VAL 2003	COL title VAL eic editorial COL authors VAL ps yu COL venue VAL ieee transactions on knowledge and data engineering , COL year VAL 2004.0	0
COL title VAL data management issues in electronic commerce ( panel ) COL authors VAL m жzsu COL venue VAL sigmod conference COL year VAL 1999	COL title VAL data management issues in electronic commerce COL authors VAL mt oezsu COL venue VAL sigmod record , COL year VAL 1999.0	1
COL title VAL the asilomar report on database research COL authors VAL p bernstein , m brodie , s ceri , d dewitt , m franklin , h garcia-molina , j gray , g held , j hellerstein , h jagadish , m lesk , d maier , j naughton , h pirahesh , m stonebraker , j ullman COL venue VAL sigmod record COL year VAL 1998	COL title VAL the asilomar report on database [ j ] COL authors VAL p bernstein , m brodie , s ceriâ ? ¦ COL venue VAL acm sigmod record , COL year VAL nan	1
COL title VAL answering queries using views : a survey COL authors VAL a halevy COL venue VAL vldb j. COL year VAL 2001	COL title VAL complexity of answering queries using materialized views COL authors VAL s abiteboul COL venue VAL nan COL year VAL nan	0
COL title VAL the nd-tree : a dynamic indexing technique for multidimensional non-ordered discrete data spaces COL authors VAL g qian , q zhu , q xue , s pramanik COL venue VAL vldb COL year VAL 2003	COL title VAL segment indexes : dynamic indexing techniques for multi-dimensional interval data COL authors VAL cp kolovson , m stonebraker COL venue VAL proceedings of the 1991 acm sigmod international conference & hellip ; , COL year VAL 1991.0	0
COL title VAL integrating modelling systems for environmental management information systems COL authors VAL d abel , k taylor , d kuo COL venue VAL sigmod record COL year VAL 1997	COL title VAL intelligent integration ofinformation COL authors VAL g wiederhold COL venue VAL & hellip ; the acm sigmod international conference on management of COL year VAL nan	0
COL title VAL fast algorithms for mining association rules in large databases COL authors VAL r agrawal , r srikant COL venue VAL vldb COL year VAL 1994	COL title VAL sample large databases for association rules COL authors VAL h toivonen COL venue VAL proceedings of the 22nd international conference on very COL year VAL nan	0
COL title VAL wrapper generation for semi-structured internet sources COL authors VAL n ashish , c knoblock COL venue VAL sigmod record COL year VAL 1997	COL title VAL wrapper generation for semi-structured information sources COL authors VAL n asish , c knoblock COL venue VAL acm sigmod , COL year VAL nan	1
COL title VAL mining fuzzy association rules in databases COL authors VAL c kuok , a fu , m wong COL venue VAL sigmod record COL year VAL 1998	COL title VAL mining generalized association rules . 1995 . 13p COL authors VAL r agrawal , r srikant COL venue VAL proceedings of 21st vldb conference zurich , COL year VAL nan	0
COL title VAL the oracle warehouse COL authors VAL g hallmark COL venue VAL vldb COL year VAL 1995	COL title VAL oracle data warehousing COL authors VAL bo ` neil , k hardy , m townsend , m whitmer , j dakin , COL venue VAL nan COL year VAL 1997.0	0
COL title VAL smooth - a distributed multimedia database system COL authors VAL h kosch , l bіszіrmщnyi , a bachlechner , c hanin , c hofbauer , m lang , c riedler , r tusch COL venue VAL vldb COL year VAL 2001	COL title VAL deadlock prevention in a distributed database system COL authors VAL pk reddy , s bhalla COL venue VAL acm sigmod record , COL year VAL 1993.0	0
COL title VAL the x-tree : an index structure for high-dimensional data COL authors VAL s berchtold , d keim , h kriegel COL venue VAL vldb COL year VAL 1996	COL title VAL pk-tree : a spatial index structure for high dimensional point data COL authors VAL w wang , j yang , rr muntz COL venue VAL nan COL year VAL nan	0
COL title VAL approximating multi-dimensional aggregate range queries over real attributes COL authors VAL d gunopulos , g kollios , v tsotras , c domeniconi COL venue VAL sigmod conference COL year VAL 2000	COL title VAL an efficient approach for approximating multi-dimensional range queries and nearest neighbor COL authors VAL c domeniconi , d gunopulos COL venue VAL nan COL year VAL nan	0
COL title VAL advanced database technologies in a diabetic healthcare system COL authors VAL w hsu , m lee , b ooi , p mohanty , k teo , c xia COL venue VAL vldb COL year VAL 2002	COL title VAL advances in real-time database systems research COL authors VAL sigmod record , 1996 COL venue VAL sigmod record , COL year VAL 1996.0	0
COL title VAL spatial joins using seeded trees COL authors VAL m lo , c ravishankar COL venue VAL sigmod conference COL year VAL 1994	COL title VAL efiienr processing of spatial joins using r-trees COL authors VAL t brink & ff , hp kriegel , b seeger COL venue VAL proc . acm sigmod int . conf . on management of data , & hellip ; , COL year VAL nan	0
COL title VAL evolution and change in data management - issues and directions COL authors VAL j roddick , l al-jadir , l bertossi , m dumas , f estrella , h gregersen , k hornsby , j lufter , f mandreoli , t mфnnistі , e mayol , l wedemeijer COL venue VAL sigmod record COL year VAL 2000	COL title VAL special section on data management issues in e-commerce COL authors VAL a dogac COL venue VAL acm sigmod record , COL year VAL nan	0
COL title VAL data grid management systems COL authors VAL a jagatheesan , a rajasekar COL venue VAL sigmod conference COL year VAL 2003	COL title VAL query processing in main memory database management systems COL authors VAL tj lehman , mj carey COL venue VAL proceedings of the 1986 acm sigmod international conference & hellip ; , COL year VAL 1986.0	0
COL title VAL a taxonomy for secure object-oriented databases COL authors VAL m olivier , s solms COL venue VAL acm trans . database syst . COL year VAL 1994	COL title VAL fhin : an efficient storage structure and access method for object-oriented databases COL authors VAL n gorla , ct liu COL venue VAL information and software technology , COL year VAL 1999.0	0
COL title VAL the worlinfo assistant : spatio-temporal information integration on the web COL authors VAL j ambite , c knoblock , m kolahdouzan , m muslea , c shahabi , s thakkar COL venue VAL vldb COL year VAL 2001	COL title VAL the information integration system k2 COL authors VAL v tannen COL venue VAL bioinformatics : managing scientific data , t. critchlow and z COL year VAL nan	0
COL title VAL database research at the university of oklahoma COL authors VAL l gruenwald , l brown , r dirckze , s guinepain , c sсnchez , b summers , s vanichayobon COL venue VAL sigmod record COL year VAL 1999	COL title VAL database research at citri COL authors VAL r sacks-davis , k ramamohanarao COL venue VAL sigmod record , COL year VAL 1992.0	0
COL title VAL the infosleuth project COL authors VAL r jr. , w bohrer , r brice , a cichocki , j fowler , a helal , v kashyap , t ksiezyk , g martin , m nodine , m rashid , m rusinkiewicz , r shea , c unnikrishnan , a unruh , d woelk COL venue VAL sigmod conference COL year VAL 1997	COL title VAL the domino project COL authors VAL ad law , ms sloman , jd moffett COL venue VAL data management â ?? 90 conference , egham , uk , COL year VAL nan	0
COL title VAL the propel distributed services platform COL authors VAL m carey , s kirsch , m roth , b linden , n adiba , m blow , d florescu , d li , i oprencak , r panwar , r qi , d rieber , j shafer , b sterling , t urhan , b vickery , d wineman , k yee COL venue VAL vldb COL year VAL 2001	COL title VAL the emergence of distributed component platforms COL authors VAL d krieger , rm adler COL venue VAL ieee computer , COL year VAL 1998.0	0
COL title VAL computing complete answers to queries in the presence of limited access patterns COL authors VAL c li COL venue VAL vldb j. COL year VAL 2003	COL title VAL computing complete answers to queries in the presence of limited access patterns COL authors VAL c li COL venue VAL the vldb journal the international journal on very large & hellip ; , COL year VAL 2003.0	1
COL title VAL query unnesting in object-oriented databases COL authors VAL l fegaras COL venue VAL sigmod conference COL year VAL 1998	COL title VAL introduction to object-oriented databases COL authors VAL w kim COL venue VAL nan COL year VAL nan	0
COL title VAL a performance evaluation of oid mapping techniques COL authors VAL a eickler , c gerlhof , d kossmann COL venue VAL vldb COL year VAL 1995	COL title VAL a performance evaluation of pointerbased joins COL authors VAL es sc901 , mj carey COL venue VAL proc . of the acm sigmod intl. ccmf : , COL year VAL nan	0
COL title VAL the ores temporal database management system COL authors VAL b theodoulidis , a ait-braham , g andrianopoulos , j chaudhary , g karvelis , s sou COL venue VAL sigmod conference COL year VAL 1994	COL title VAL the ecrc multi database system COL authors VAL w jonker , h schã 1/4 tz COL venue VAL proceedings of the 1995 acm sigmod international conference & hellip ; , COL year VAL 1995.0	0
COL title VAL an algebraic approach to rule analysis in expert database systems COL authors VAL e baralis , j widom COL venue VAL vldb COL year VAL 1994	COL title VAL database design tools : an expert system approach COL authors VAL m bouzeghoub , g gardarin , e metais COL venue VAL vldb , COL year VAL nan	0
COL title VAL aurora : a data stream management system COL authors VAL d abadi , d carney , u чetintemel , m cherniack , c convey , c erwin , e galvez , m hatoun , a maskey , a rasin , a singer , m stonebraker , n tatbul , y xing , r yan , s zdonik COL venue VAL sigmod conference COL year VAL 2003	COL title VAL elements of data management systems COL authors VAL gg dodd COL venue VAL acm computing surveys ( csur ) , COL year VAL 1969.0	0
COL title VAL supporting top-k join queries in relational databases COL authors VAL i ilyas , w aref , a elmagarmid COL venue VAL vldb COL year VAL 2003	COL title VAL efficiently monitoring relational databases COL authors VAL op buneman , ek clemons COL venue VAL acm transactions on database systems ( tods ) , COL year VAL 1979.0	0
COL title VAL index nesting - an efficient approach to indexing in object-oriented databases COL authors VAL b ooi , j han , h lu , k tan COL venue VAL vldb j. COL year VAL 1996	COL title VAL integrating active concepts into an object-oriented database system . COL authors VAL acms anthology COL venue VAL nan COL year VAL nan	0
COL title VAL guest editor 's introduction COL authors VAL nan COL venue VAL nan COL year VAL 1998	COL title VAL introduction COL authors VAL p alston COL venue VAL see ref , COL year VAL 1990.0	0
COL title VAL efficient and extensible algorithms for multi query optimization COL authors VAL p roy , s seshadri , s sudarshan , s bhobe COL venue VAL sigmod conference COL year VAL 2000	COL title VAL efficient algorithm for bcnf-decomposition COL authors VAL wy lin COL venue VAL information and software technology , COL year VAL 1992.0	0
COL title VAL birch : an efficient data clustering method for very large databases COL authors VAL t zhang , r ramakrishnan , m livny COL venue VAL sigmod conference COL year VAL 1996	COL title VAL an efficient structure for string databases COL authors VAL t kahveci , ak singh COL venue VAL vldb , rome , september , COL year VAL nan	0
COL title VAL applying update streams in a soft real-time database system COL authors VAL b adelberg , h garcia-molina , b kao COL venue VAL sigmod conference COL year VAL 1995	COL title VAL maintaining security and timeliness in real-time database system COL authors VAL qn ahmed , sv vrbsky COL venue VAL journal of systems and software , COL year VAL 2002.0	0
COL title VAL data extraction and transformation for the data warehouse COL authors VAL c squire COL venue VAL sigmod conference COL year VAL 1995	COL title VAL data extraction and transformation for the data warehouse COL authors VAL c squire COL venue VAL proceedings of the 1995 acm sigmod international conference & hellip ; , COL year VAL 1995.0	1
COL title VAL the design and implementation of a sequence database system COL authors VAL p seshadri , m livny , r ramakrishnan COL venue VAL vldb COL year VAL 1996	COL title VAL design and implementation of the glue-nail database system COL authors VAL mads morishita , g phippst COL venue VAL nan COL year VAL nan	0
COL title VAL the mariposa distributed database management system COL authors VAL j sidell COL venue VAL sigmod record COL year VAL 1996	COL title VAL hydro : a heterogeneous distributed database system COL authors VAL , j rajkumar , p ram COL venue VAL nan COL year VAL nan	0
COL title VAL guest editorial COL authors VAL nan COL venue VAL nan COL year VAL 2001	COL title VAL editorial COL authors VAL d hopwood , me boon COL venue VAL the histochemical journal , COL year VAL 1988.0	0
COL title VAL semantics for update rule programs and implementations in a relational database management system COL authors VAL l raschid , j lobo COL venue VAL acm trans . database syst . COL year VAL 1996	COL title VAL supporting multi-media object management in a relational database management system COL authors VAL lm haas COL venue VAL technical report . ibm almaden research center , COL year VAL nan	0
COL title VAL the ecrc multi database system COL authors VAL w jonker , h schќtz COL venue VAL sigmod conference COL year VAL 1995	COL title VAL the database language gem COL authors VAL c zamolo COL venue VAL proceedmgs of 1983 acm sigmod conference , ( may COL year VAL nan	0
COL title VAL efficient optimistic concurrency control using loosely synchronized clocks COL authors VAL a adya , r gruber , b liskov , u maheshwari COL venue VAL sigmod conference COL year VAL 1995	COL title VAL efficient optimistic concurrency control using loosely synchronized clocks , acm sigmod int COL authors VAL a adya , r gruber , b liskov , u maheshwari COL venue VAL conf . on management of data , COL year VAL nan	1
COL title VAL managing intervals efficiently in object-relational databases COL authors VAL h kriegel , m pіtke , t seidl COL venue VAL vldb COL year VAL 2000	COL title VAL converting relational to object-oriented databases COL authors VAL j fong COL venue VAL sigmod record , COL year VAL 1997.0	0
COL title VAL towards self-tuning data placement in parallel database systems COL authors VAL m lee , m kitsuregawa , b ooi , k tan , a mondal COL venue VAL sigmod conference COL year VAL 2000	COL title VAL dynamic load balancing in parallel database systems COL authors VAL e rahm COL venue VAL nan COL year VAL nan	0
COL title VAL oracle industrial exhibit COL authors VAL a pogue COL venue VAL vldb COL year VAL 1998	COL title VAL objectivity industrial exhibit . COL authors VAL acms disc , acms anthology , p edition COL venue VAL nan COL year VAL nan	0
COL title VAL foundations of preferences in database systems COL authors VAL w kieпling COL venue VAL vldb COL year VAL 2002	COL title VAL foundations of preferences in database systems COL authors VAL w kiessling COL venue VAL vldb , COL year VAL 2002.0	1
COL title VAL minimization of tree pattern queries COL authors VAL s amer-yahia , s cho , l lakshmanan , d srivastava COL venue VAL sigmod conference COL year VAL 2001	COL title VAL minimization of tree pattem queries COL authors VAL sa yahia , s cho , lvs lakshmananâ ? ¦ COL venue VAL proc of the acm sigmod COL year VAL nan	1
COL title VAL view management in multimedia databases COL authors VAL k candan , e lemar , v subrahmanian COL venue VAL vldb j. COL year VAL 2000	COL title VAL efficient management of inconsistent databases COL authors VAL a fuxman , e fazli , rj miller COL venue VAL acm sigmod international conference on management of data , COL year VAL nan	0
COL title VAL enterprise transaction processing on windows nt COL authors VAL g hope COL venue VAL sigmod conference COL year VAL 1995	COL title VAL secure real-time transaction processing COL authors VAL b george COL venue VAL nan COL year VAL nan	0
COL title VAL converting relational to object-oriented databases COL authors VAL j fong COL venue VAL sigmod record COL year VAL 1997	COL title VAL java and relational databases COL authors VAL g clossman , p shaw , m hapner , j klein , r COL venue VAL proceedings of 1998 acm sigmod conference on management of & hellip ; , COL year VAL nan	0
COL title VAL birch : an efficient data clustering method for very large databases COL authors VAL t zhang , r ramakrishnan , m livny COL venue VAL sigmod conference COL year VAL 1996	COL title VAL cure : an efficient clustering algorithm for large database COL authors VAL s guha , r rastogi , k shim COL venue VAL proc . acm sigmod int . conf . on management of data , seattle , & hellip ; , COL year VAL nan	0
COL title VAL structural matching and discovery in document databases COL authors VAL j wang , d shasha , g chang , l relihan , k zhang , g patel COL venue VAL sigmod conference COL year VAL 1997	COL title VAL structural matching and discovery in document databases COL authors VAL jtl wang , gjs chang COL venue VAL sigmod conference , COL year VAL 1997.0	1
COL title VAL turbo-charging vertical mining of large databases COL authors VAL p shenoy , j haritsa , s sudarshan , g bhalotia , m bawa , d shah COL venue VAL sigmod conference COL year VAL 2000	COL title VAL towards on-line analytical mining in large databases . COL authors VAL acms anthology COL venue VAL sigmod record , COL year VAL 1998.0	0
COL title VAL updates for structure indexes COL authors VAL r kaushik , p bohannon , j naughton , p shenoy COL venue VAL vldb COL year VAL 2002	COL title VAL singh : , ak efficient index structures for string databases COL authors VAL t kahveci COL venue VAL proc . of the international conference on very large data COL year VAL nan	0
COL title VAL repositories and object oriented databases COL authors VAL p bernstein COL venue VAL sigmod record COL year VAL 1998	COL title VAL index configuration in object-oriented databases COL authors VAL e bertino COL venue VAL the vldb journal the international journal on very large & hellip ; , COL year VAL 1994.0	0
COL title VAL index research : forest or trees ? ( panel abstract ) COL authors VAL j hellerstein COL venue VAL sigmod conference COL year VAL 2000	COL title VAL indexing research : forest or trees ? COL authors VAL jm hellerstein COL venue VAL sigmod record , COL year VAL 2000.0	1
COL title VAL approximate query translation across heterogeneous information sources COL authors VAL k chang , h garcia-molina COL venue VAL vldb COL year VAL 2000	COL title VAL querying heterogeneous information sources using source descriptions . 22th vldb COL authors VAL ay levy , a rajaramanâ ? ¦ COL venue VAL bombay , india , COL year VAL nan	0
COL title VAL an adaptive data replication algorithm COL authors VAL o wolfson , s jajodia , y huang COL venue VAL acm trans . database syst . COL year VAL 1997	COL title VAL a distributed algorithm for adaptive replication of data COL authors VAL o wolfson COL venue VAL nan COL year VAL 1990.0	1
COL title VAL a general techniques for querying xml documents using a relational database system COL authors VAL j shanmugasundaram , e shekita , j kiernan , r krishnamurthy , s viglas , j naughton , i tatarinov COL venue VAL sigmod record COL year VAL 2001	COL title VAL implementation techniques for main memory database systems COL authors VAL djdwrh katz , f olken , ld shapiro , mr stonebraker , COL venue VAL mt. proc . of acm COL year VAL nan	0
COL title VAL online association rule mining COL authors VAL c hidber COL venue VAL sigmod conference COL year VAL 1999	COL title VAL privacy-preserving association rule mining COL authors VAL sj rizvi , jr haritsa COL venue VAL proc . of the 28th intâ ?? l conference on very large databases , COL year VAL nan	0
COL title VAL query unnesting in object-oriented databases COL authors VAL l fegaras COL venue VAL sigmod conference COL year VAL 1998	COL title VAL insight into object-oriented databases COL authors VAL s khoshafian COL venue VAL information and software technology , COL year VAL 1990.0	0
COL title VAL building knowledge base management systems COL authors VAL j mylopoulos , v chaudhri , d plexousakis , a shrufi , t topaloglou COL venue VAL vldb j. COL year VAL 1996	COL title VAL osam * . kbms : an object-oriented knowledge base management system for supporting advanced COL authors VAL syw su , h lam , s eddula , j arroyo , n prasad , r COL venue VAL nan COL year VAL nan	0
COL title VAL vqbd : exploring semistructured data COL authors VAL s chawathe , t baby , j yeo COL venue VAL sigmod conference COL year VAL 2001	COL title VAL storing semistructured datawith stored COL authors VAL a deutsch , m fernandez , d suciu COL venue VAL & hellip ; of the acm sigmod international conference on management of & hellip ; , COL year VAL nan	0
COL title VAL fast algorithms for mining association rules in large databases COL authors VAL r agrawal , r srikant COL venue VAL vldb COL year VAL 1994	COL title VAL an effective hash-based algorithm for mining association rules COL authors VAL js park , ps yu COL venue VAL nan COL year VAL nan	0
COL title VAL the sift information dissemination system COL authors VAL t yan , h garcia-molina COL venue VAL acm trans . database syst . COL year VAL 1999	COL title VAL duplicate removal in information system dissemination COL authors VAL tw yan , h garcia-molina COL venue VAL proceedings of the 21th international conference on very & hellip ; , COL year VAL 1995.0	0
COL title VAL fast algorithms for universal quantification in large databases COL authors VAL g graefe , r cole COL venue VAL acm trans . database syst . COL year VAL 1995	COL title VAL fast algorithms for mining association rules in large databases COL authors VAL r agrawal , r srikant COL venue VAL nan COL year VAL 1994.0	0
COL title VAL theory of dependence values COL authors VAL r meo COL venue VAL acm trans . database syst . COL year VAL 2000	COL title VAL the theory of matrices COL authors VAL fr gantmacher COL venue VAL nan COL year VAL nan	0
COL title VAL incremental data structures and algorithms for dynamic query interfaces COL authors VAL e tanin , r beigel , b shneiderman COL venue VAL sigmod record COL year VAL 1996	COL title VAL incremental distance join algorithms for spatial databases COL authors VAL grhh samet COL venue VAL proc . of the acm sigmod COL year VAL nan	0
COL title VAL query optimization in compressed database systems COL authors VAL z chen , j gehrke , f korn COL venue VAL sigmod conference COL year VAL 2001	COL title VAL semantic query optimization in datalog programs COL authors VAL ay levy , y sagiv COL venue VAL nan COL year VAL nan	0
COL title VAL a shrinking-based approach for multi-dimensional data analysis COL authors VAL y shi , y song , a zhang COL venue VAL vldb COL year VAL 2003	COL title VAL lvs â ?? a foundation for multi-dimensional databasesâ ?? COL authors VAL ml gyssens COL venue VAL proc . 22 ndvldb conference , india , COL year VAL nan	0
COL title VAL a database interface for file updates COL authors VAL s abiteboul , s cluet , t milo COL venue VAL sigmod conference COL year VAL 1995	COL title VAL a dialogue interface for data base applications COL authors VAL r studer COL venue VAL vldb , COL year VAL 1980.0	0
COL title VAL the design and implementation of a sequence database system COL authors VAL p seshadri , m livny , r ramakrishnan COL venue VAL vldb COL year VAL 1996	COL title VAL xquery implementation in a relational database system COL authors VAL s pal , i cseri , o seeliger , m rys , g schaller , w COL venue VAL submitted for COL year VAL nan	0
COL title VAL infering structure in semistructured data COL authors VAL s nestorov , s abiteboul , r motwani COL venue VAL sigmod record COL year VAL 1997	COL title VAL query optimization for semistructured data COL authors VAL j mchugh , j widom COL venue VAL proc . vldb , COL year VAL 1999.0	0
COL title VAL parallel database systems 101 COL authors VAL j gray COL venue VAL sigmod conference COL year VAL 1995	COL title VAL the ores temporal database system COL authors VAL b theodolidis , ga ait-braham , j chaudhary , g COL venue VAL proc . acm sigmod conf . on the management of data , COL year VAL nan	0
COL title VAL size separation spatial join COL authors VAL n koudas , k sevcik COL venue VAL sigmod conference COL year VAL 1997	COL title VAL on spatially partitioned temporal join COL authors VAL h lu , bc ooi , kl tan COL venue VAL proceedings of the international conference on very large & hellip ; , COL year VAL 1994.0	0
COL title VAL high-performance sorting on networks of workstations COL authors VAL a arpaci-dusseau , r arpaci-dusseau , d culler , j hellerstein , d patterson COL venue VAL sigmod conference COL year VAL 1997	COL title VAL high-performance sorting on networks of workstations COL authors VAL ac arpaci-dusseau , rh arpaci-dusseau , de culler , COL venue VAL sigmod conference , COL year VAL 1997.0	1
COL title VAL a probabilistic relational model and algebra COL authors VAL d dey , s sarkar COL venue VAL acm trans . database syst . COL year VAL 1996	COL title VAL tata probabilistic temporal databases , i : algebra COL authors VAL a dekhtyar , r ross , vs subrahmanian COL venue VAL technical report cs-tr-3987 , department of computer science , COL year VAL nan	0
COL title VAL estimating the output cardinality of partial preaggregation with a measure of clusteredness COL authors VAL s helmer , t neumann , g moerkotte COL venue VAL vldb COL year VAL 2003	COL title VAL estimating the output cardinality of partial preaggregation with a measure of clusteredness COL authors VAL s helmer , t neumann , g moerkotte COL venue VAL proceedings of the international conference on very large & hellip ; , COL year VAL 2003.0	1
COL title VAL a logical foundation for deductive object-oriented databases COL authors VAL m liu , g dobbie , t ling COL venue VAL acm trans . database syst . COL year VAL 2002	COL title VAL mga : rule-based specification of active object-oriented database applications COL authors VAL p sawyer , i sommerville COL venue VAL information and software technology , COL year VAL 1995.0	0
COL title VAL advances in real-time database systems research COL authors VAL a bestavros COL venue VAL sigmod record COL year VAL 1996	COL title VAL issues and approaches to design of real-time database systems COL authors VAL m singhal COL venue VAL sigmod record , COL year VAL 1988.0	0
COL title VAL implementation of magic-sets in a relational database system COL authors VAL i mumick , h pirahesh COL venue VAL sigmod conference COL year VAL 1994	COL title VAL design and implementation of the glue-nail database system COL authors VAL ma derr , s morishita , g phipps COL venue VAL proceedings of the 1993 acm sigmod international conference & hellip ; , COL year VAL 1993.0	0
COL title VAL editor 's notes COL authors VAL m franklin COL venue VAL sigmod record COL year VAL 1998	COL title VAL editor 's notes COL authors VAL dw leslie COL venue VAL new directions for higher education , COL year VAL nan	0
COL title VAL fas - a freshness-sensitive coordination middleware for a cluster of olap components COL authors VAL u rіhm , k bіhm , h schek , h schuldt COL venue VAL vldb COL year VAL 2002	COL title VAL fas-a freshness-sensitive coordination middleware for a cluster of olap components COL authors VAL u rohm , k bohm , hj schek , h schuldt COL venue VAL int . conf . on very large data bases , COL year VAL 2002.0	1
COL title VAL building and customizing data-intensive web sites using weave COL authors VAL k yagoub , d florescu , v issarny , p valduriez COL venue VAL vldb COL year VAL 2000	COL title VAL design and maintenance of data-intensive web sites . COL authors VAL acms anthology COL venue VAL nan COL year VAL nan	0
COL title VAL mining fuzzy association rules in databases COL authors VAL c kuok , a fu , m wong COL venue VAL sigmod record COL year VAL 1998	COL title VAL an efficient algorithm for mining association in large databases COL authors VAL a savasere , e omiecinski , s navathe COL venue VAL nan COL year VAL nan	0
COL title VAL using unknowns to prevent discovery of association rules COL authors VAL y saygin , v verykios , c clifton COL venue VAL sigmod record COL year VAL 2001	COL title VAL privacy preserving of association rules COL authors VAL r agrawal , r srikant , a evfimievski , j gehrke COL venue VAL proceeding of 8th acm sigmod conference on knowledge & hellip ; , COL year VAL nan	0
COL title VAL cost-based selection of path expression processing algorithms in object-oriented databases COL authors VAL g gardarin , j gruser , z tang COL venue VAL vldb COL year VAL 1996	COL title VAL static detection of security flaws in object-oriented databases COL authors VAL k tajima COL venue VAL sigmod conference , COL year VAL 1996.0	0
COL title VAL the incinerate data model COL authors VAL h jagadish COL venue VAL acm trans . database syst . COL year VAL 1995	COL title VAL the language and the data model COL authors VAL r agrawal , n gehani COL venue VAL proceedings of the acm-sigmod conference ( portland , or , june , COL year VAL nan	0
COL title VAL an axiomatic model of dynamic schema evolution in objectbase systems COL authors VAL r peters , m жzsu COL venue VAL acm trans . database syst . COL year VAL 1997	COL title VAL others , schema and database evolution in the o 2 object database system COL authors VAL f ferrandina , t meyer , r zicari COL venue VAL proc . vldb ( sep. . COL year VAL nan	0
COL title VAL database principles column - introduction COL authors VAL l libkin COL venue VAL sigmod record COL year VAL 1999	COL title VAL database tuning : principles COL authors VAL d shasha , p bonnet COL venue VAL experiments and troubleshooting techniques , morgan kaufmann , COL year VAL nan	0
COL title VAL dynamic multi-resource load balancing in parallel database systems COL authors VAL e rahm , r marek COL venue VAL vldb COL year VAL 1995	COL title VAL signature caching in parallel object database systems COL authors VAL k norvag COL venue VAL information and software technology , COL year VAL 2002.0	0
COL title VAL guest editorial COL authors VAL nan COL venue VAL nan COL year VAL 2000	COL title VAL editorial COL authors VAL rr knight COL venue VAL bt technology journal , COL year VAL 1998.0	0
COL title VAL unisql 's next-generation object-relational database management system COL authors VAL a d'andrea , p janus COL venue VAL sigmod record COL year VAL 1996	COL title VAL performance enhancements to a relational database system COL authors VAL m stonebraker , j woodfill , j ranstrom , m murphy , m COL venue VAL acm transactions on database systems , COL year VAL 1983.0	0
COL title VAL materialized views selection in a multidimensional database COL authors VAL e baralis , s paraboschi , e teniente COL venue VAL vldb COL year VAL 1997	COL title VAL materialized view selection in a multidimensional database COL authors VAL e baralis , s paraboschi , e teniente COL venue VAL vldb , COL year VAL 1997.0	1
COL title VAL structures for manipulating proposed updates in object-oriented databases COL authors VAL m doherty , r hull , m rupawalla COL venue VAL sigmod conference COL year VAL 1996	COL title VAL join index hierarchies for supporting efficient navigations in object-oriented databases COL authors VAL z xie , j han COL venue VAL vldb , COL year VAL 1994.0	0
COL title VAL query processing techniques for arrays COL authors VAL a marathe , k salem COL venue VAL vldb j. COL year VAL 2002	COL title VAL query processingfor distance metrics COL authors VAL tl wang , d shasha COL venue VAL proc . of 16th vldb COL year VAL nan	0
COL title VAL integrating modelling systems for environmental management information systems COL authors VAL d abel , k taylor , d kuo COL venue VAL sigmod record COL year VAL 1997	COL title VAL infomaster : an information integration system COL authors VAL mr genesereth , am keller , om duschka COL venue VAL nan COL year VAL nan	0
COL title VAL communication efficient distributed mining of association rules COL authors VAL a schuster , r wolff COL venue VAL sigmod conference COL year VAL 2001	COL title VAL efficient mining for fuzzy implication-based association rules in quantitative databases COL authors VAL g chen , p yan , ee kerre COL venue VAL international journal of general systems , COL year VAL 2004.0	0
COL title VAL efficiently publishing relational data as xml documents COL authors VAL j shanmugasundaram , e shekita , r barr , m carey , b lindsay , h pirahesh , b reinwald COL venue VAL vldb j. COL year VAL 2001	COL title VAL efficiently publishing relational data as xml documents COL authors VAL m carey , b lindsay , h pirahesh , b reinwald COL venue VAL proc . COL year VAL nan	1
COL title VAL managing a db2 parallel edition database COL authors VAL g fecteau COL venue VAL vldb COL year VAL 1995	COL title VAL managing intra-operator parallelism in parallel database systems COL authors VAL m mehta COL venue VAL proceedings of the international conference on very large & hellip ; , COL year VAL 1995.0	0
COL title VAL efficiently publishing relational data as xml documents COL authors VAL j shanmugasundaram , e shekita , r barr , m carey , b lindsay , h pirahesh , b reinwald COL venue VAL vldb j. COL year VAL 2001	COL title VAL efficiently supporting procedures in relational database systems COL authors VAL tk sellis COL venue VAL nan COL year VAL nan	0
COL title VAL a logical foundation for deductive object-oriented databases COL authors VAL m liu , g dobbie , t ling COL venue VAL acm trans . database syst . COL year VAL 2002	COL title VAL logic and objectoriented programming language paradigms with application to deductive databases COL authors VAL zo bayram COL venue VAL nan COL year VAL nan	0
COL title VAL open object database management systems COL authors VAL nan COL venue VAL nan COL year VAL 1994	COL title VAL extensible database management systems COL authors VAL mj carey , lm haas COL venue VAL sigmod record , COL year VAL 1990.0	0
COL title VAL temporal aggregation in active database rules COL authors VAL i motakis , c zaniolo COL venue VAL sigmod conference COL year VAL 1997	COL title VAL the design and implementation of the ariel active database rule system COL authors VAL en hanson COL venue VAL nan COL year VAL nan	0
COL title VAL metu interoperable database system COL authors VAL a dogac , u halici , e kilic , g жzhan , f ozcan , s nural , c dengi , s mancuhan , i arpinar , p koksal , c evrendilek COL venue VAL sigmod conference COL year VAL 1996	COL title VAL metu interoperable database system COL authors VAL al dogac aet COL venue VAL proceedings of the 1996 acm sigmod int . conf . on management COL year VAL nan	1
COL title VAL discovery of multiple-level association rules from large databases COL authors VAL j han , y fu COL venue VAL vldb COL year VAL 1995	COL title VAL an efficient algorithm for mining association rules in large databases COL authors VAL a savasere , e omiecinski , s navathe COL venue VAL nan COL year VAL 1995.0	0
COL title VAL editor 's notes COL authors VAL l liu COL venue VAL sigmod record COL year VAL 2003	COL title VAL editors ' notes COL authors VAL jh astrachan COL venue VAL nan COL year VAL nan	0
COL title VAL disima : a distributed and interoperable image database system COL authors VAL v oria , m жzsu , p iglinski , s lin , b yao COL venue VAL sigmod conference COL year VAL 2000	COL title VAL din-a-mit : an adaptable , distributed computer-based message system . COL authors VAL wl bauerfeld , p kaufmann , m tschichholz , c weikart COL venue VAL computer networks , COL year VAL 1984.0	0
COL title VAL secure bufering in firm real-time database systems COL authors VAL b george , j haritsa COL venue VAL vldb j. COL year VAL 2000	COL title VAL an annotated bibliography on real-time database systems COL authors VAL o ulusoy COL venue VAL sigmod record , COL year VAL 1995.0	0
COL title VAL an aspect of query optimization in multidatabase systems ( extended abstract ) COL authors VAL c lee , c chen , h lu COL venue VAL sigmod record COL year VAL 1995	COL title VAL query optimization in compressed database systems COL authors VAL z chen , j gehrke , f korn COL venue VAL nan COL year VAL nan	0
COL title VAL supply chain infrastructures : system integration and information sharing COL authors VAL m ball , m ma , l raschid , z zhao COL venue VAL sigmod record COL year VAL 2002	COL title VAL infomaster : an information integration system COL authors VAL mr genesereth , am keller , om duschka COL venue VAL nan COL year VAL nan	0
COL title VAL reminiscences on influential papers COL authors VAL nan COL venue VAL nan COL year VAL 2003	COL title VAL reminiscences on influential papers . COL authors VAL acms anthology COL venue VAL sigmod COL year VAL 1998.0	0
COL title VAL optimizing the secure evaluation of twig queries COL authors VAL s cho , s amer-yahia , l lakshmanan , d srivastava COL venue VAL vldb COL year VAL 2002	COL title VAL optimization of dynamic query evaluation plans COL authors VAL rl cole , g graefe COL venue VAL proceedings of the 1994 acm sigmod international conference & hellip ; , COL year VAL 1994.0	0
COL title VAL discovering all most specific sentences COL authors VAL d gunopulos , r khardon , h mannila , s saluja , h toivonen , r sharm COL venue VAL acm trans . database syst . COL year VAL 2003	COL title VAL discovering all most specific sentences by randomized algorithms . COL authors VAL acms anthology COL venue VAL nan COL year VAL nan	0
COL title VAL flexible and scalable digital library search COL authors VAL h blok , m windhouwer , r zwol , m petkovic , p apers , m kersten , w jonker COL venue VAL vldb COL year VAL 2001	COL title VAL flexible and scalable digital library search COL authors VAL he blok , m windhouwer , r van zwol , m petkovic , pmg COL venue VAL proceedings of the international conference on very large & hellip ; , COL year VAL 2001.0	1
COL title VAL neurorule : a connectionist approach to data mining COL authors VAL h lu , r setiono , h liu COL venue VAL vldb COL year VAL 1995	COL title VAL neurorule : a connectionist approach to data mining COL authors VAL h lu , r setiono , h liu COL venue VAL vldb , COL year VAL 1995.0	1
COL title VAL an extension of the relational data model to incorporate ordered domains COL authors VAL w ng COL venue VAL acm trans . database syst . COL year VAL 2001	COL title VAL an ? swenson , jr on the semantics of the relational data model COL authors VAL ha schmid COL venue VAL proc . acm sigmod conf. , wf king , ed. , san jose , calif. , may , COL year VAL nan	0
COL title VAL database systems - breaking out of the box COL authors VAL a silberschatz , s zdonik COL venue VAL sigmod record COL year VAL 1997	COL title VAL the breakdown of the information model in multi-database systems COL authors VAL w kent COL venue VAL sigmod record , COL year VAL 1991.0	0
COL title VAL tutorial : application servers and associated technologies COL authors VAL nan COL venue VAL nan COL year VAL 2002	COL title VAL advanced technology seminar : application servers and associated technologies COL authors VAL c mohan COL venue VAL 19 thieee international conference on data engineering ( icde & hellip ; , COL year VAL nan	1
COL title VAL cure : an efficient clustering algorithm for large databases COL authors VAL s guha , r rastogi , k shim COL venue VAL sigmod conference COL year VAL 1998	COL title VAL cure : an efficient clustering algorithm for large database COL authors VAL s guha , r rastogi , k shim COL venue VAL proc . acm sigmod int . conf . on management of data , seattle , & hellip ; , COL year VAL nan	1
COL title VAL data grid management systems COL authors VAL a jagatheesan , a rajasekar COL venue VAL sigmod conference COL year VAL 2003	COL title VAL dwms : data warehouse management system COL authors VAL n mohan COL venue VAL proceedings of the international conference on very large & hellip ; , COL year VAL 1996.0	0
COL title VAL rp * : a family of order preserving scalable distributed data structures COL authors VAL w litwin , m neimat , d schneider COL venue VAL vldb COL year VAL 1994	COL title VAL scalable , distributed data structures for internet service construction COL authors VAL sd gribble , ea brewer , jm hellerstein , de culler COL venue VAL nan COL year VAL nan	0
COL title VAL editor 's notes COL authors VAL nan COL venue VAL nan COL year VAL 2001	COL title VAL editor 's notes COL authors VAL te cyrs COL venue VAL new directions for teaching and learning , COL year VAL nan	0
COL title VAL the ecrc multi database system COL authors VAL w jonker , h schќtz COL venue VAL sigmod conference COL year VAL 1995	COL title VAL the indiana center for database systems COL authors VAL j copler COL venue VAL acm sigmod record , COL year VAL 1991.0	0
COL title VAL referee : an open framework for practical testing of recommender systems using researchindex COL authors VAL d cosley , s lawrence , d pennock COL venue VAL vldb COL year VAL 2002	COL title VAL s. and pennock , dm 2002 . referee : an open framework for practical testing of recommender systems COL authors VAL dl cosley COL venue VAL proceedings of the 28 thinternational conference on very COL year VAL nan	1
COL title VAL integration of data mining with database technology COL authors VAL a netz , s chaudhuri , j bernhardt , u fayyad COL venue VAL vldb COL year VAL 2000	COL title VAL integrating association rule mining with databases : alternatives and implications COL authors VAL s sarawagi , s thomas , r agrawal COL venue VAL acm sigmod intl. conf . management of data , COL year VAL nan	0
COL title VAL webservice composition with o'grape and osiris COL authors VAL r weber , c schuler , p neukomm , h schuldt , h schek COL venue VAL vldb COL year VAL 2003	COL title VAL web service composition with o'grape and osiris COL authors VAL r weber , c schuler , p neukomm , h schuldt , hj schek COL venue VAL proceedings of the international conference on very large & hellip ; , COL year VAL 2003.0	1
COL title VAL commercial use of database technology COL authors VAL h schіning COL venue VAL vldb COL year VAL 2003	COL title VAL integration of data mining with database technology COL authors VAL a netz , s chaudhuri , j bernhardt , um fayyad COL venue VAL proceedings of the 26th international conference on very & hellip ; , COL year VAL 2000.0	0
COL title VAL dbglobe : a service-oriented p2p system for global computing COL authors VAL e pitoura , s abiteboul , d pfoser , g samaras , m vazirgiannis COL venue VAL sigmod record COL year VAL 2003	COL title VAL dbglobe : a service-oriented p2p system for global computing COL authors VAL s abiteboul , d pfoser , e pitoura , g samaras , m COL venue VAL acm sigmod record , COL year VAL nan	1
COL title VAL treasurer 's message COL authors VAL nan COL venue VAL nan COL year VAL 2003	COL title VAL head/director 's message COL authors VAL rdae status COL venue VAL nan COL year VAL nan	0
COL title VAL the algres testbed of chimera : an active object-oriented database system COL authors VAL s ceri , p fraternali , s paraboschi , g psaila COL venue VAL sigmod conference COL year VAL 1995	COL title VAL exact : an extensible approach to active object-oriented databases COL authors VAL o dãaz , a jaime COL venue VAL the vldb journal the international journal on very large & hellip ; , COL year VAL 1997.0	0
COL title VAL designing and mining multi-terabyte astronomy archives : the sloan digital sky survey COL authors VAL a szalay , p kunszt , a thakar , j gray , d slutz COL venue VAL sigmod conference COL year VAL 2000	COL title VAL , pz kunszt . designing and mining multi-terabyte astronomy archives : the sloan digital sky survey COL authors VAL atjgdr slutz COL venue VAL nan COL year VAL 2000.0	1
COL title VAL qcluster : relevance feedback using adaptive clustering for content-based image retrieval COL authors VAL d kim , c chung COL venue VAL sigmod conference COL year VAL 2003	COL title VAL a novel log-based relevance feedback technique in content-based image retrieval COL authors VAL ch hoi , mr lyu COL venue VAL proceedings of the 12th annual acm international conference & hellip ; , COL year VAL 2004.0	0
COL title VAL fast algorithms for universal quantification in large databases COL authors VAL g graefe , r cole COL venue VAL acm trans . database syst . COL year VAL 1995	COL title VAL an efficient algorithm for mining association in large databases COL authors VAL a savasere , e omiecinski , s navathe COL venue VAL nan COL year VAL nan	0
COL title VAL reminiscences on influential papers COL authors VAL nan COL venue VAL nan COL year VAL 2002	COL title VAL reminiscences of an indian official COL authors VAL o cavenagh COL venue VAL nan COL year VAL 1884.0	0
