COL title VAL the building blocks for specifying communication behavior of complex objects : an activity-driven approach COL authors VAL ling liu , robert meersman COL venue VAL acm trans . database syst . COL year VAL 1996	COL title VAL the building blocks for specifying communication behavior of complex objects : an activity-driven approach COL authors VAL ling liu , robert meersman COL venue VAL acm transactions on database systems ( tods ) COL year VAL 1996	1
COL title VAL a database interface for file updates COL authors VAL tova milo , serge abiteboul , sophie cluet COL venue VAL sigmod conference COL year VAL 1995	COL title VAL a database platform for bioinformatics COL authors VAL sandeepan banerjee COL venue VAL very large data bases COL year VAL 2000	0
COL title VAL cure : an efficient clustering algorithm for large databases COL authors VAL sudipto guha , rajeev rastogi , kyuseok shim COL venue VAL sigmod conference COL year VAL 1998	COL title VAL the hcc-tree : an efficient index structure for object oriented databases COL authors VAL b. sreenath , s. seshadri COL venue VAL very large data bases COL year VAL 1994	0
COL title VAL qcluster : relevance feedback using adaptive clustering for content-based image retrieval COL authors VAL deok-hwan kim , chin-wan chung COL venue VAL sigmod conference COL year VAL 2003	COL title VAL qcluster : relevance feedback using adaptive clustering for content-based image retrieval COL authors VAL deok-hwan kim , chin-wan chung COL venue VAL international conference on management of data COL year VAL 2003	1
COL title VAL design and implementation of a genetic-based algorithm for data mining COL authors VAL sunil choenni COL venue VAL vldb COL year VAL 2000	COL title VAL cost-based optimization for magic : algebra and implementation COL authors VAL praveen seshadri , joseph m. hellerstein , hamid pirahesh , t. y. cliff leung , raghu ramakrishnan , divesh srivastava , peter j. stuckey , s. sudarshan COL venue VAL international conference on management of data COL year VAL 1996	0
COL title VAL extracting schema from semistructured data COL authors VAL serge abiteboul , rajeev motwani , svetlozar nestorov COL venue VAL sigmod conference COL year VAL 1998	COL title VAL management of semistructured data COL authors VAL dan suciu COL venue VAL acm sigmod record COL year VAL 1997	0
COL title VAL call for book reviews COL authors VAL karl aberer COL venue VAL sigmod record COL year VAL 2003	COL title VAL book review column COL authors VAL karl aberer COL venue VAL acm sigmod record COL year VAL 2002	0
COL title VAL re-tree : an efficient index structure for regular expressions COL authors VAL chee yong chan , minos n. garofalakis , rajeev rastogi COL venue VAL vldb j. COL year VAL 2003	COL title VAL re-tree : an efficient index structure for regular expressions COL authors VAL chee-yong chan , minos garofalakis , rajeev rastogi COL venue VAL the vldb journal -- the international journal on very large data bases COL year VAL 2003	1
COL title VAL editor 's notes COL authors VAL ling liu COL venue VAL sigmod record COL year VAL 2003	COL title VAL editorial COL authors VAL peter apers , stefano ceri , richard snodgrass COL venue VAL the vldb journal -- the international journal on very large data bases COL year VAL 2002	0
COL title VAL multi-dimensional resource scheduling for parallel queries COL authors VAL yannis e. ioannidis , minos n. garofalakis COL venue VAL sigmod conference COL year VAL 1996	COL title VAL resource scheduling for composite multimedia objects COL authors VAL minos n. garofalakis , yannis e. ioannidis , banu &#214; zden COL venue VAL very large data bases COL year VAL 1998	0
COL title VAL a performance study of four index structures for set-valued attributes of low cardinality COL authors VAL guido moerkotte , sven helmer COL venue VAL vldb j. COL year VAL 2003	COL title VAL a performance study of four index structures for set-valued attributes of low cardinality COL authors VAL sven helmer , guido moerkotte COL venue VAL the vldb journal -- the international journal on very large data bases COL year VAL 2003	1
COL title VAL the implementation and performance of compressed databases COL authors VAL till westmann , sven helmer , guido moerkotte , donald kossmann COL venue VAL sigmod record COL year VAL 2000	COL title VAL performing joins without decompression in a compressed database system COL authors VAL s. j. o'connell , n. winterbottom COL venue VAL acm sigmod record COL year VAL 2003	0
COL title VAL guest editor 's introduction COL authors VAL robert meersman , amit p. sheth COL venue VAL sigmod record COL year VAL 2002	COL title VAL data management issues in electronic commerce : guest editor 's introduction COL authors VAL asuman dogac COL venue VAL acm sigmod record COL year VAL 2002	0
COL title VAL bringing order to query optimization COL authors VAL giedrius slivinskas , richard t. snodgrass , christian s. jensen COL venue VAL sigmod record COL year VAL 2002	COL title VAL outerjoin simplification and reordering for query optimization COL authors VAL c &#233; sar galindo-legaria , arnon rosenthal COL venue VAL acm transactions on database systems ( tods ) COL year VAL 1997	0
COL title VAL maintenance of data cubes and summary tables in a warehouse COL authors VAL inderpal singh mumick , dallan quass , barinderpal singh mumick COL venue VAL sigmod conference COL year VAL 1997	COL title VAL view maintenance in a warehousing environment COL authors VAL yue zhuge , h &#233; ctor garc &#237; a-molina , joachim hammer , jennifer widom COL venue VAL international conference on management of data COL year VAL 1995	0
COL title VAL chair 's message COL authors VAL richard t. snodgrass COL venue VAL sigmod record COL year VAL 2000	COL title VAL treasurer 's message COL authors VAL joachim hammer COL venue VAL acm sigmod record COL year VAL 2002	0
COL title VAL naos - efficient and modular reactive capabilities in an object-oriented database system COL authors VAL thierry coupaye , t. svensen , christine collet COL venue VAL vldb COL year VAL 1994	COL title VAL odefs : a file system interface to an object-oriented database COL authors VAL narain h. gehani , h. v. jagadish , william d. roome COL venue VAL very large data bases COL year VAL 1994	0
COL title VAL approximate computation of multidimensional aggregates of sparse data using wavelets COL authors VAL min wang , jeffrey scott vitter COL venue VAL sigmod conference COL year VAL 1999	COL title VAL explaining differences in multidimensional aggregates COL authors VAL sunita sarawagi COL venue VAL very large data bases COL year VAL 1999	0
COL title VAL evaluating functional joins along nested reference sets in object-relational and object-oriented databases COL authors VAL alfons kemper , reinhard braumandl , jens claußen COL venue VAL vldb COL year VAL 1998	COL title VAL a logical foundation for deductive object-oriented databases COL authors VAL mengchi liu , gillian dobbie , tok wang ling COL venue VAL acm transactions on database systems ( tods ) COL year VAL 2002	0
COL title VAL the mariposa distributed database management system COL authors VAL jeff sidell COL venue VAL sigmod record COL year VAL 1996	COL title VAL the ores temporal database management system COL authors VAL babis theodoulidis , aziz ait-braham , george andrianopoulos , jayant chaudhary , george karvelis , simon sou COL venue VAL international conference on management of data COL year VAL 1994	0
COL title VAL supporting dynamic displays using active rules COL authors VAL oscar díaz , arturo jaime , ghassan al-qaimari , norman w. paton COL venue VAL sigmod record COL year VAL 1994	COL title VAL supporting dynamic displays using active rules COL authors VAL oscar d &#237; az , arturo jaime , norman w. paton , ghassan al-qaimari COL venue VAL acm sigmod record COL year VAL 1994	1
COL title VAL database research at the indian institute of technology , bombay COL authors VAL s. seshadri , nandlal l. sarda , d. b. phatak , s. sudarshan COL venue VAL sigmod record COL year VAL 1996	COL title VAL database research at arizona state university COL authors VAL susan d. urban , suzanne w. dietrich , forouzan golshani COL venue VAL acm sigmod record COL year VAL 1996	0
COL title VAL data management for earth system science COL authors VAL james frew , jeff dozier COL venue VAL sigmod record COL year VAL 1997	COL title VAL open object database management systems COL authors VAL jos &#233; a. blakeley COL venue VAL international conference on management of data COL year VAL 1994	0
COL title VAL c2p : clustering based on closest pairs COL authors VAL yannis theodoridis , alexandros nanopoulos , yannis manolopoulos COL venue VAL vldb COL year VAL 2001	COL title VAL c2p : clustering based on closest pairs COL authors VAL alexandros nanopoulos , yannis theodoridis , yannis manolopoulos COL venue VAL very large data bases COL year VAL 2001	1
COL title VAL spotfire : an information exploration environment COL authors VAL christopher ahlberg COL venue VAL sigmod record COL year VAL 1996	COL title VAL infosleuth : agent-based semantic integration of information in open and dynamic environments COL authors VAL r. j. bayardo , jr. , w. bohrer , r. brice , a. cichocki , j. fowler , a. helal , v. kashyap , t. ksiezyk , g. martin , m. nodine , m. rashid , m. rusinkiewicz , r. shea , c. unnikrishnan , a. unruh , d. woelk COL venue VAL international conference on management of data COL year VAL 1997	0
COL title VAL fast algorithms for maintaining replica consistency in lazy master replicated databases COL authors VAL eric simon , esther pacitti , pascale minet COL venue VAL vldb COL year VAL 1999	COL title VAL fast algorithms for maintaining replica consistency in lazy master replicated databases COL authors VAL esther pacitti , pascale minet , eric simon COL venue VAL very large data bases COL year VAL 1999	1
COL title VAL world wide database - integrating the web , corba , and databases COL authors VAL kevin smith , athman bouguettaya , mourad ouzzani , james beard , lily hendra , boualem benatallah COL venue VAL sigmod conference COL year VAL 1999	COL title VAL integrating reliable memory in databases COL authors VAL wee teck ng , peter m. chen COL venue VAL very large data bases COL year VAL 1997	0
COL title VAL a fast index for semistructured data COL authors VAL brian cooper , gísli r. hjaltason , michael j. franklin , neal sample , moshe shadmon COL venue VAL vldb COL year VAL 2001	COL title VAL incremental maintenance for materialized views over semistructured data COL authors VAL serge abiteboul , jason mchugh , michael rys , vasilis vassalos , janet l. wiener COL venue VAL very large data bases COL year VAL 1998	0
COL title VAL automatic subspace clustering of high dimensional data for data mining applications COL authors VAL johannes gehrke , rakesh agrawal , dimitrios gunopulos , prabhakar raghavan COL venue VAL sigmod conference COL year VAL 1998	COL title VAL spatial indexing of high-dimensional data based on relative approximation COL authors VAL yasushi sakurai , masatoshi yoshikawa , shunsuke uemura , haruhiko kojima COL venue VAL the vldb journal -- the international journal on very large data bases COL year VAL 2002	0
COL title VAL views in a large scale xml repository COL authors VAL dan vodislav , sophie cluet , pierangelo veltri COL venue VAL vldb COL year VAL 2001	COL title VAL views in a large-scale xml repository COL authors VAL vincent aguilera , sophie cluet , tova milo , pierangelo veltri , dan vodislav COL venue VAL the vldb journal -- the international journal on very large data bases COL year VAL 2002	0
COL title VAL approximate frequency counts over data streams COL authors VAL rajeev motwani , gurmeet singh manku COL venue VAL vldb COL year VAL 2002	COL title VAL approximate join processing over data streams COL authors VAL abhinandan das , johannes gehrke , mirek riedewald COL venue VAL international conference on management of data COL year VAL 2003	0
COL title VAL xl : a platform for web services COL authors VAL andreas grünhagen , steffen rost , donald kossmann , daniela florescu COL venue VAL sigmod conference COL year VAL 2002	COL title VAL xl : a platform for web services COL authors VAL daniela florescu , andreas gr &#252; nhagen , donald kossmann , steffen rost COL venue VAL international conference on management of data COL year VAL 2002	1
COL title VAL parallel evaluation of multi-join queries COL authors VAL jan flokstra , annita n. wilschut , peter m. g. apers COL venue VAL sigmod conference COL year VAL 1995	COL title VAL on applying hash filters to improving the execution of multi-join queries COL authors VAL ming-syan chen , hui-i hsiao , philip s. yu COL venue VAL the vldb journal -- the international journal on very large data bases COL year VAL 1997	0
COL title VAL the aditi deductive database system COL authors VAL kotagiri ramamohanarao , david b. kemp , jayen vaghani , tim s. leask , james harland , peter j. stuckey , zoltan somogyi COL venue VAL vldb j. COL year VAL 1994	COL title VAL promises and realities of active database systems COL authors VAL eric simon , angelika kotz dittrich COL venue VAL very large data bases COL year VAL 1995	0
COL title VAL describing semistructured data COL authors VAL luca cardelli COL venue VAL sigmod record COL year VAL 2001	COL title VAL vqbd : exploring semistructured data COL authors VAL sudarshan s. chawathe , thomas baby , jihwang yoo COL venue VAL international conference on management of data COL year VAL 2001	0
COL title VAL temporal conditions and integrity constraints in active database systems COL authors VAL ouri wolfson , a. prasad sistla COL venue VAL sigmod conference COL year VAL 1995	COL title VAL temporal conditions and integrity constraints in active database systems COL authors VAL a. prasad sistla , ouri wolfson COL venue VAL international conference on management of data COL year VAL 1995	1
COL title VAL formal query languages for secure relational databases COL authors VAL marianne winslett , kenneth smith , xiaolei qian COL venue VAL acm trans . database syst . COL year VAL 1994	COL title VAL safe query languages for constraint databases COL authors VAL peter z. revesz COL venue VAL acm transactions on database systems ( tods ) COL year VAL 1998	0
COL title VAL semantic interoperability in information services : experiencing with coopware COL authors VAL avigdor gal COL venue VAL sigmod record COL year VAL 1999	COL title VAL semantic interoperability in information services : experiencing with coopware COL authors VAL avigdor gal COL venue VAL acm sigmod record COL year VAL 1999	1
COL title VAL book review column COL authors VAL karl aberer COL venue VAL sigmod record COL year VAL 2002	COL title VAL book reviews COL authors VAL karl aberer COL venue VAL acm sigmod record COL year VAL 2002	0
COL title VAL query flocks : a generalization of association-rule mining COL authors VAL chris clifton , svetlozar nestorov , rajeev motwani , shalom tsur , jeffrey d. ullman , arnon rosenthal , serge abiteboul COL venue VAL sigmod conference COL year VAL 1998	COL title VAL query flocks : a generalization of association-rule mining COL authors VAL dick tsur , jeffrey d. ullman , serge abiteboul , chris clifton , rajeev motwani , svetlozar nestorov , arnon rosenthal COL venue VAL international conference on management of data COL year VAL 1998	1
COL title VAL extraction of object-oriented structures from existing relational databases COL authors VAL julia e. hodges , shekar ramanathan COL venue VAL sigmod record COL year VAL 1997	COL title VAL converting relational to object-oriented databases COL authors VAL joseph fong COL venue VAL acm sigmod record COL year VAL 1997	0
COL title VAL resource scheduling for composite multimedia objects COL authors VAL yannis e. ioannidis , minos n. garofalakis , banu özden COL venue VAL vldb COL year VAL 1998	COL title VAL resource scheduling in enhanced pay-per-view continuous media databases COL authors VAL minos n. garofalakis , banu &#214; zden , abraham silberschatz COL venue VAL very large data bases COL year VAL 1997	0
COL title VAL a fast index for semistructured data COL authors VAL brian cooper , gísli r. hjaltason , michael j. franklin , neal sample , moshe shadmon COL venue VAL vldb COL year VAL 2001	COL title VAL semistructured and structured data in the web : going back and forth COL authors VAL paolo atzeni , giansalvatore mecca , paolo merialdo COL venue VAL acm sigmod record COL year VAL 1997	0
COL title VAL efficient algorithms for processing xpath queries COL authors VAL reinhard pichler , georg gottlob , christoph koch COL venue VAL vldb COL year VAL 2002	COL title VAL efficient algorithms for minimizing tree pattern queries COL authors VAL prakash ramanan COL venue VAL international conference on management of data COL year VAL 2002	0
COL title VAL generating efficient plans for queries using views COL authors VAL chen li , jeffrey d. ullman , foto n. afrati COL venue VAL sigmod conference COL year VAL 2001	COL title VAL a scalable algorithm for answering queries using views COL authors VAL rachel pottinger , alon y. levy COL venue VAL very large data bases COL year VAL 2000	0
COL title VAL ghost : fine granularity buffering of indexes COL authors VAL cheng hian goh , kian-lee tan , beng chin ooi , d. sim COL venue VAL vldb COL year VAL 1999	COL title VAL ghost : fine granularity buffering of indexes COL authors VAL cheng hian goh , beng chin ooi , d. sim , kian-lee tan COL venue VAL very large data bases COL year VAL 1999	1
COL title VAL managing intra-operator parallelism in parallel database systems COL authors VAL david j. dewitt , manish mehta COL venue VAL vldb COL year VAL 1995	COL title VAL data partitioning and load balancing in parallel disk systems COL authors VAL peter scheuermann , gerhard weikum , peter zabback COL venue VAL the vldb journal -- the international journal on very large data bases COL year VAL 1998	0
COL title VAL new concurrency control algorithms for accessing and compacting b-trees COL authors VAL andrea zisman , v. w. setzer COL venue VAL vldb COL year VAL 1994	COL title VAL transactional information systems : theory , algorithms , and the practice of concurrency control and recovery COL authors VAL marc h. scholl COL venue VAL acm sigmod record COL year VAL 2001	0
COL title VAL research issues in federated database systems : report of efdbs '97 workshop COL authors VAL fèlix saltor , mark roantree , mark w. w. vermeer , wilhelm hasselbring , martin schönhoff , markus strässler , barry eaglestone , stefan conrad COL venue VAL sigmod record COL year VAL 1997	COL title VAL research issues in federated database systems : report of efdbs '97 workshop COL authors VAL s. conrad , b. eaglestone , w. hasselbring , m. roantree , m. sch &#246; hoff , m. str &#228; ssler , m. vermeer , f. saltor COL venue VAL acm sigmod record COL year VAL 1997	1
COL title VAL converting relational to object-oriented databases COL authors VAL joseph fong COL venue VAL sigmod record COL year VAL 1997	COL title VAL an efficient method for checking object-oriented database schema correctness COL authors VAL a. formica , h. d. groger , m. missikoff COL venue VAL acm transactions on database systems ( tods ) COL year VAL 1998	0
COL title VAL automated selection of materialized views and indexes in sql databases COL authors VAL surajit chaudhuri , sanjay agrawal , vivek r. narasayya COL venue VAL vldb COL year VAL 2000	COL title VAL efficient materialization and use of views in data warehouses COL authors VAL m &#225; rcio farias de souza , marcus costa sampaio COL venue VAL acm sigmod record COL year VAL 1999	0
COL title VAL outerjoin simplification and reordering for query optimization COL authors VAL césar a. galindo-legaria , arnon rosenthal COL venue VAL acm trans . database syst . COL year VAL 1997	COL title VAL efficient and extensible algorithms for multi query optimization COL authors VAL prasan roy , s. seshadri , s. sudarshan , siddhesh bhobe COL venue VAL international conference on management of data COL year VAL 2000	0
COL title VAL on efficiently implementing schemasql on an sql database system COL authors VAL fereidoon sadri , laks v. s. lakshmanan , subbu n. subramanian COL venue VAL vldb COL year VAL 1999	COL title VAL temporal database system implementations COL authors VAL michael h. b &#246; hlen COL venue VAL acm sigmod record COL year VAL 1995	0
COL title VAL report on second international workshop on advanced issues of e-commerce and web-based information systems COL authors VAL philip s. yu , kun-lung wu COL venue VAL sigmod record COL year VAL 2000	COL title VAL advances in databases and information systems : report of 5th east european conference adbis ' 2001 COL authors VAL albertas caplinskas , johann eder , olegas vasilecas COL venue VAL acm sigmod record COL year VAL 2002	0
COL title VAL xquery : a query language for xml COL authors VAL donald d. chamberlin COL venue VAL sigmod conference COL year VAL 2003	COL title VAL a graphical query language for mobile information systems COL authors VAL ya-hui chang COL venue VAL acm sigmod record COL year VAL 2003	0
COL title VAL providing better support for a class of decision support queries COL authors VAL antonio badia , dirk van gucht , sudhir rao COL venue VAL sigmod conference COL year VAL 1996	COL title VAL cost-based optimization of decision support queries using transient-views COL authors VAL subbu n. subramanian , shivakumar venkataraman COL venue VAL international conference on management of data COL year VAL 1998	0
COL title VAL disima : a distributed and interoperable image database system COL authors VAL vincent oria , benjamin bin yao , shu lin , paul iglinski , m. tamer özsu COL venue VAL sigmod conference COL year VAL 2000	COL title VAL smooth - a distributed multimedia database system COL authors VAL harald kosch , l &#225; szl &#243; b &#246; sz &#246; rm &#233; nyi , alexander bachlechner , christian hanin , christian hofbauer , margit lang , carmen riedler , roland tusch COL venue VAL very large data bases COL year VAL 2001	0
COL title VAL efficiently instantiating view-objects from remote relational databases COL authors VAL gio wiederhold , byung suk lee COL venue VAL vldb j. COL year VAL 1994	COL title VAL extraction of object-oriented structures from existing relational databases COL authors VAL shekar ramanathan , julia hodges COL venue VAL acm sigmod record COL year VAL 1997	0
COL title VAL space optimization in deductive databases COL authors VAL s. sudarshan , divesh srivastava , raghu ramakrishnan , jeffrey f. naughton COL venue VAL acm trans . database syst . COL year VAL 1995	COL title VAL introduction to constraint databases COL authors VAL bart kuijpers COL venue VAL acm sigmod record COL year VAL 2002	0
COL title VAL report on the nsf workshop on building an infrastructure for mobile and wireless systems COL authors VAL ouri wolfson , s. a. m. makki , kia makki , charles e. perkins , birgitta könig-ries , peter l. reiher , niki pissinou , peter scheuermann , jari veijalainen COL venue VAL sigmod record COL year VAL 2002	COL title VAL towards an infrastructure for temporal databases : report of an invitational arpa/nsf workshop COL authors VAL niki pissinou , richard thomas snodgrass , ramez elmasri , inderpal s. mumick , tamer &#214; zsu , barbara pernici , arie segev , babis theodoulidis , umeshwar dayal COL venue VAL acm sigmod record COL year VAL 1994	0
COL title VAL applying update streams in a soft real-time database system COL authors VAL brad adelberg , hector garcia-molina , ben kao COL venue VAL sigmod conference COL year VAL 1995	COL title VAL improving timeliness in real-time secure database systems COL authors VAL sang h. son , rasikan david , bhavani thuraisingham COL venue VAL acm sigmod record COL year VAL 1996	0
COL title VAL groupwise processing of relational queries COL authors VAL kenneth a. ross , damianos chatziantoniou COL venue VAL vldb COL year VAL 1997	COL title VAL congressional samples for approximate answering of group-by queries COL authors VAL swarup acharya , phillip b. gibbons , viswanath poosala COL venue VAL international conference on management of data COL year VAL 2000	0
COL title VAL belief reasoning in mls deductive databases COL authors VAL hasan m. jamil COL venue VAL sigmod conference COL year VAL 1999	COL title VAL the aditi deductive database system COL authors VAL jayen vaghani , kotagiri ramamohanarao , david b. kemp , zoltan somogyi , peter j. stuckey , tim s. leask , james harland COL venue VAL the vldb journal -- the international journal on very large data bases COL year VAL 1994	0
COL title VAL xxl - a library approach to supporting efficient implementations of advanced database queries COL authors VAL björn blohsfeld , jens-peter dittrich , martin schneider , bernhard seeger , tobias schäfer , jochen van den bercken , jürgen krämer COL venue VAL vldb COL year VAL 2001	COL title VAL index nesting - an efficient approach to indexing in object-oriented databases COL authors VAL beng chin ooi , jiawei han , hongjun lu , kian lee tan COL venue VAL the vldb journal -- the international journal on very large data bases COL year VAL 1996	0
COL title VAL databases for gis COL authors VAL claudia bauzer medeiros , fatima pires COL venue VAL sigmod record COL year VAL 1994	COL title VAL standard for multimedia databases COL authors VAL john r. smith COL venue VAL international conference on management of data COL year VAL 2001	0
COL title VAL information translation , mediation , and mosaic-based browsing in the tsimmis system COL authors VAL yannis papakonstantinou , joachim hammer , jennifer widom , jeffrey d. ullman , hector garcia-molina , kelly ireland COL venue VAL sigmod conference COL year VAL 1995	COL title VAL information gathering in the world-wide web : the w3ql query language and the w3qs system COL authors VAL david konopnicki , oded shmueli COL venue VAL acm transactions on database systems ( tods ) COL year VAL 1998	0
COL title VAL semantic video indexing : approach and issue COL authors VAL arun hampapur COL venue VAL sigmod record COL year VAL 1999	COL title VAL semantic video indexing : approach and issues COL authors VAL arun hampapur COL venue VAL acm sigmod record COL year VAL 1999	1
COL title VAL optimization of dynamic query evaluation plans COL authors VAL goetz graefe , richard l. cole COL venue VAL sigmod conference COL year VAL 1994	COL title VAL efficient mid-query re-optimization of sub-optimal query execution plans COL authors VAL navin kabra , david j. dewitt COL venue VAL international conference on management of data COL year VAL 1998	0
COL title VAL query optimization for selections using bitmaps COL authors VAL ming-chuan wu COL venue VAL sigmod conference COL year VAL 1999	COL title VAL exploiting statistics on query expressions for optimization COL authors VAL nicolas bruno , surajit chaudhuri COL venue VAL international conference on management of data COL year VAL 2002	0
COL title VAL dna-miner : a system prototype for mining dna sequences COL authors VAL jiawei han , liangyou chen , jian pei , ying lu , yaqin liao , hasan m. jamil COL venue VAL sigmod conference COL year VAL 2001	COL title VAL geominer : a system prototype for spatial data mining COL authors VAL jaiwei han , krzysztof koperski , nebojsa stefanovic COL venue VAL international conference on management of data COL year VAL 1997	0
COL title VAL processing object-oriented queries with invertible late bound functions COL authors VAL tore risch , staffan flodin COL venue VAL vldb COL year VAL 1995	COL title VAL processing object-oriented queries with invertible late bound functions COL authors VAL staffan flodin , tore risch COL venue VAL very large data bases COL year VAL 1995	1
COL title VAL hd-eye : visual clustering of high dimensional data COL authors VAL daniel a. keim , markus wawryniuk , alexander hinneburg COL venue VAL sigmod conference COL year VAL 2002	COL title VAL multi-dimensional clustering : a new data layout scheme in db2 COL authors VAL sriram padmanabhan , bishwaranjan bhattacharjee , tim malkemus , leslie cranston , matthew huras COL venue VAL international conference on management of data COL year VAL 2003	0
COL title VAL special issue on data mining for intrusion detection and threat analysis - guest editor 's introduction COL authors VAL daniel barbará COL venue VAL sigmod record COL year VAL 2001	COL title VAL data management issues in electronic commerce : guest editor 's introduction COL authors VAL asuman dogac COL venue VAL acm sigmod record COL year VAL 2002	0
COL title VAL the ores temporal database management system COL authors VAL babis theodoulidis , george karvelis , jayant chaudhary , aziz ait-braham , simon sou , george andrianopoulos COL venue VAL sigmod conference COL year VAL 1994	COL title VAL coalescing in temporal databases COL authors VAL michael h. b &#246; hlen , richard thomas snodgrass , michael d. soo COL venue VAL very large data bases COL year VAL 1996	0
COL title VAL birch : an efficient data clustering method for very large databases COL authors VAL raghu ramakrishnan , miron livny , tian zhang COL venue VAL sigmod conference COL year VAL 1996	COL title VAL wavecluster : a wavelet-based clustering approach for spatial data in very large databases COL authors VAL gholamhosein sheikholeslami , surojit chatterjee , aidong zhang COL venue VAL the vldb journal -- the international journal on very large data bases COL year VAL 2000	0
COL title VAL temporal aggregation in active database rules COL authors VAL iakovos motakis , carlo zaniolo COL venue VAL sigmod conference COL year VAL 1997	COL title VAL tail recursion elimination in deductive databases COL authors VAL kenneth a. ross COL venue VAL acm transactions on database systems ( tods ) COL year VAL 1996	0
COL title VAL the database group at national technical university of athens ( ntua ) COL authors VAL timos k. sellis , yannis vassiliou COL venue VAL sigmod record COL year VAL 1995	COL title VAL the database group at national technical university of athens ( ntua ) COL authors VAL corporate national technical univ. of athens COL venue VAL acm sigmod record COL year VAL 1995	1
COL title VAL multi-dimensional substring selectivity estimation COL authors VAL divesh srivastava , olga kapitskaia , raymond t. ng , h. v. jagadish COL venue VAL vldb COL year VAL 1999	COL title VAL hierarchical subspace sampling : a unified framework for high dimensional data reduction , selectivity estimation and nearest neighbor search COL authors VAL charu c. aggarwal COL venue VAL international conference on management of data COL year VAL 2002	0
COL title VAL querying multiple features of groups in relational databases COL authors VAL damianos chatziantoniou , kenneth a. ross COL venue VAL vldb COL year VAL 1996	COL title VAL enhanced abstract data types in object-relational databases COL authors VAL praveen seshadri COL venue VAL the vldb journal -- the international journal on very large data bases COL year VAL 1998	0
COL title VAL incremental maintenance for materialized views over semistructured data COL authors VAL vasilis vassalos , janet l. wiener , michael rys , serge abiteboul , jason mchugh COL venue VAL vldb COL year VAL 1998	COL title VAL incremental maintenance of recursive views using relational calculus/sql COL authors VAL guozhu dong , jianwen su COL venue VAL acm sigmod record COL year VAL 2000	0
COL title VAL database research at the university of illinois at urbana-champaign COL authors VAL chengxiang zhai , marianne winslett , yuanyuan zhou , kevin chen-chuan chang , jiawei han , anhai doan COL venue VAL sigmod record COL year VAL 2002	COL title VAL the database group at university of hagen COL authors VAL gunter schlageter , thomas berkel , eberhard heuel , silke mittrach , andreas scherer , wolfgang wilkes COL venue VAL acm sigmod record COL year VAL 1995	0
COL title VAL calibrating the query optimizer cost model of iro-db , an object-oriented federated database system COL authors VAL zhao-hui tang , fei sha , georges gardarin COL venue VAL vldb COL year VAL 1996	COL title VAL query unnesting in object-oriented databases COL authors VAL leonidas fegaras COL venue VAL international conference on management of data COL year VAL 1998	0
COL title VAL amicalola report : database and information system research challenges and opportunities in semantic web and enterprises COL authors VAL robert meersman , amit p. sheth COL venue VAL sigmod record COL year VAL 2002	COL title VAL advances in databases and information systems : report of 5th east european conference adbis ' 2001 COL authors VAL albertas caplinskas , johann eder , olegas vasilecas COL venue VAL acm sigmod record COL year VAL 2002	0
COL title VAL an overview of data warehousing and olap technology COL authors VAL surajit chaudhuri , umeshwar dayal COL venue VAL sigmod record COL year VAL 1997	COL title VAL data warehousing and olap for decision support COL authors VAL surajit chaudhuri , umeshwar dayal COL venue VAL international conference on management of data COL year VAL 1997	0
COL title VAL load shedding in a data stream manager COL authors VAL michael stonebraker , nesime tatbul , mitch cherniack , stanley b. zdonik , ugur çetintemel COL venue VAL vldb COL year VAL 2003	COL title VAL aurora : a data stream management system COL authors VAL d. abadi , d. carney , u. &#199; etintemel , m. cherniack , c. convey , c. erwin , e. galvez , m. hatoun , a. maskey , a. rasin , a. singer , m. stonebraker , n. tatbul , y. xing , r. yan , s. zdonik COL venue VAL international conference on management of data COL year VAL 2003	0
COL title VAL editor 's notes COL authors VAL arie segev COL venue VAL sigmod record COL year VAL 1994	COL title VAL editorial COL authors VAL peter apers , stefano ceri , richard snodgrass COL venue VAL the vldb journal -- the international journal on very large data bases COL year VAL 2002	0
COL title VAL picture programming project COL authors VAL nita goyal , moshé m. zloof , charles hoch , michael suckow , ravi krishnamurthy , brian meckler COL venue VAL sigmod conference COL year VAL 1997	COL title VAL picture programming project COL authors VAL nita goyal , charles hoch , ravi krishnamurthy , brian meckler , michael suchow , moshe zloof COL venue VAL international conference on management of data COL year VAL 1997	1
COL title VAL enhanced abstract data types in object-relational databases COL authors VAL praveen seshadri COL venue VAL vldb j. COL year VAL 1998	COL title VAL unisql 's next-generation object-relational database management system COL authors VAL albert d'andrea , phil janus COL venue VAL acm sigmod record COL year VAL 1996	0
COL title VAL factorizing complex predicates in queries to exploit indexes COL authors VAL prasanna ganesan , sunita sarawagi , surajit chaudhuri COL venue VAL sigmod conference COL year VAL 2003	COL title VAL hypergraph based reorderings of outer join queries with complex predicates COL authors VAL gautam bhargava , piyush goel , bala iyer COL venue VAL international conference on management of data COL year VAL 1995	0
COL title VAL answering queries with aggregation using views COL authors VAL h. v. jagadish , shaul dar , divesh srivastava , alon y. levy COL venue VAL vldb COL year VAL 1996	COL title VAL answering queries using views : a survey COL authors VAL alon y. halevy COL venue VAL the vldb journal -- the international journal on very large data bases COL year VAL 2001	0
COL title VAL enhanced abstract data types in object-relational databases COL authors VAL praveen seshadri COL venue VAL vldb j. COL year VAL 1998	COL title VAL extraction of object-oriented structures from existing relational databases COL authors VAL shekar ramanathan , julia hodges COL venue VAL acm sigmod record COL year VAL 1997	0
COL title VAL materialized view selection for multidimensional datasets COL authors VAL jeffrey f. naughton , amit shukla , prasad deshpande COL venue VAL vldb COL year VAL 1998	COL title VAL multi-dimensional substring selectivity estimation COL authors VAL h. v. jagadish , olga kapitskaia , raymond t. ng , divesh srivastava COL venue VAL very large data bases COL year VAL 1999	0
COL title VAL semantic integration in heterogeneous databases using neural networks COL authors VAL chris clifton , wen-syan li COL venue VAL vldb COL year VAL 1994	COL title VAL automated resolution of semantic heterogeneity in multidatabases COL authors VAL m. w. bright , a. r. hurson , s. pakzad COL venue VAL acm transactions on database systems ( tods ) COL year VAL 1994	0
COL title VAL implementation of magic-sets in a relational database system COL authors VAL inderpal singh mumick , hamid pirahesh COL venue VAL sigmod conference COL year VAL 1994	COL title VAL on supporting containment queries in relational database management systems COL authors VAL chun zhang , jeffrey naughton , david dewitt , qiong luo , guy lohman COL venue VAL international conference on management of data COL year VAL 2001	0
COL title VAL automating physical database design in a parallel database COL authors VAL chun zhang , guy m. lohman , jun rao , nimrod megiddo COL venue VAL sigmod conference COL year VAL 2002	COL title VAL data placement in shared-nothing parallel database systems COL authors VAL manish mehta , david j. dewitt COL venue VAL the vldb journal -- the international journal on very large data bases COL year VAL 1997	0
COL title VAL champagne : data change propagation for heterogeneous information systems COL authors VAL holger meinecke , uwe heinkel , ralf rantzau , carmen constantinescu COL venue VAL vldb COL year VAL 2002	COL title VAL declustering databases on heterogeneous disk systems COL authors VAL ling tony chen , doron rotem , sidhar seshadri COL venue VAL very large data bases COL year VAL 1995	0
COL title VAL the challenge of process data warehousing COL authors VAL matthias jarke , jörg köller , thomas list COL venue VAL vldb COL year VAL 2000	COL title VAL the ins and outs ( and everything in between ) of data warehousing COL authors VAL phil fernandez , donovan schneider COL venue VAL international conference on management of data COL year VAL 1996	0
COL title VAL foreword : management of semistructured data COL authors VAL dan suciu COL venue VAL sigmod record COL year VAL 1997	COL title VAL management of semistructured data COL authors VAL dan suciu COL venue VAL acm sigmod record COL year VAL 1997	1
COL title VAL fast algorithms for mining association rules in large databases COL authors VAL ramakrishnan srikant , rakesh agrawal COL venue VAL vldb COL year VAL 1994	COL title VAL fast algorithms for maintaining replica consistency in lazy master replicated databases COL authors VAL esther pacitti , pascale minet , eric simon COL venue VAL very large data bases COL year VAL 1999	0
COL title VAL business data management for b2b electronic commerce COL authors VAL manfred a. jeusfeld , mareike schoop , christoph quix COL venue VAL sigmod record COL year VAL 2002	COL title VAL active views for electronic commerce COL authors VAL serge abiteboul , bernd amann , sophie cluet , adi eyal , laurent mignet , tova milo COL venue VAL very large data bases COL year VAL 1999	0
COL title VAL thémis : a database programming language handling integrity constraints COL authors VAL anne doucet , véronique benzaken COL venue VAL vldb j. COL year VAL 1995	COL title VAL the role of integrity constraints in database interoperation COL authors VAL mark w. w. vermeer , peter m. g. apers COL venue VAL very large data bases COL year VAL 1996	0
COL title VAL improving adaptable similarity query processing by using approximations COL authors VAL hans-peter kriegel , bernhard braunmüller , thomas seidl , mihael ankerst COL venue VAL vldb COL year VAL 1998	COL title VAL similarity query processing using disk arrays COL authors VAL apostolos n. papadopoulos , yannis manolopoulos COL venue VAL international conference on management of data COL year VAL 1998	0
COL title VAL accessing a relational database through an object-oriented database interface COL authors VAL jack a. orenstein , d. n. kamber COL venue VAL vldb COL year VAL 1995	COL title VAL static detection of security flaws in object-oriented databases COL authors VAL keishi tajima COL venue VAL international conference on management of data COL year VAL 1996	0
COL title VAL efficient view maintenance at data warehouses COL authors VAL tolga yurek , divyakant agrawal , amr el abbadi , ambuj k. singh COL venue VAL sigmod conference COL year VAL 1997	COL title VAL multiple-view self-maintenance in data warehousing environments COL authors VAL nam huyn COL venue VAL very large data bases COL year VAL 1997	0
COL title VAL d ( k ) - index : an adaptive structural summary for graph-structured data COL authors VAL chen qun , andrew lim , kian win ong COL venue VAL sigmod conference COL year VAL 2003	COL title VAL the x-tree : an index structure for high-dimensional data COL authors VAL stefan berchtold , daniel a. keim , hans-peter kriegel COL venue VAL very large data bases COL year VAL 1996	0
COL title VAL data stream query processing : a tutorial COL authors VAL divesh srivastava , nick koudas COL venue VAL vldb COL year VAL 2003	COL title VAL approximate join processing over data streams COL authors VAL abhinandan das , johannes gehrke , mirek riedewald COL venue VAL international conference on management of data COL year VAL 2003	0
COL title VAL the multidimensional database system rasdaman COL authors VAL andreas dehmel , peter baumann , norbert widmann , roland ritsch , paula furtado COL venue VAL sigmod conference COL year VAL 1998	COL title VAL optimizing multiple dimensional queries simultaneously in multidimensional databases COL authors VAL weifa liang , maria e. orlowska , jeffrey x. yu COL venue VAL the vldb journal -- the international journal on very large data bases COL year VAL 2000	0
COL title VAL an adaptive query execution system for data integration COL authors VAL daniel s. weld , alon y. levy , marc friedman , zachary g. ives , daniela florescu COL venue VAL sigmod conference COL year VAL 1999	COL title VAL an adaptive query execution system for data integration COL authors VAL zachary g. ives , daniela florescu , marc friedman , alon levy , daniel s. weld COL venue VAL international conference on management of data COL year VAL 1999	1
COL title VAL managing multiple and distributed ontologies on the semantic web COL authors VAL boris motik , alexander maedche , ljiljana stojanovic COL venue VAL vldb j. COL year VAL 2003	COL title VAL the &#961; operator : discovering and ranking associations on the semantic web COL authors VAL kemafor anyanwu , amit sheth COL venue VAL acm sigmod record COL year VAL 2002	0
COL title VAL dblearn : a system prototype for knowledge discovery in relational databases COL authors VAL yue huang , yandong cai , yongjian fu , nick cercone , jiawei han COL venue VAL sigmod conference COL year VAL 1994	COL title VAL complex relationships and knowledge discovery support in the infoquilt system COL authors VAL a. sheth , s. thacker , s. patel COL venue VAL the vldb journal -- the international journal on very large data bases COL year VAL 2003	0
COL title VAL pc database systems - present and future COL authors VAL philip a. bernstein COL venue VAL vldb COL year VAL 1994	COL title VAL database management systems and the internet COL authors VAL susan malaika COL venue VAL very large data bases COL year VAL 1996	0
COL title VAL extraction of object-oriented structures from existing relational databases COL authors VAL julia e. hodges , shekar ramanathan COL venue VAL sigmod record COL year VAL 1997	COL title VAL a taxonomy for secure object-oriented databases COL authors VAL martin s. olivier , sebastiaan h. von solms COL venue VAL acm transactions on database systems ( tods ) COL year VAL 1994	0
COL title VAL actiview : adaptive data presentation using supersql COL authors VAL motomichi toyama , yoko maeda COL venue VAL vldb COL year VAL 2001	COL title VAL actiview : adaptive data presentation using supersql COL authors VAL yoko maeda , motomichi toyama COL venue VAL very large data bases COL year VAL 2001	1
COL title VAL open object database management systems COL authors VAL josé a. blakeley COL venue VAL sigmod conference COL year VAL 1994	COL title VAL the network is the database : data management for highly distributed systems COL authors VAL julio c. navas , michael wynblatt COL venue VAL international conference on management of data COL year VAL 2001	0
COL title VAL book review column COL authors VAL karl aberer COL venue VAL sigmod record COL year VAL 2002	COL title VAL book reviews COL authors VAL karl aberer COL venue VAL acm sigmod record COL year VAL 2002	0
COL title VAL supporting top-k join queries in relational databases COL authors VAL walid g. aref , ahmed k. elmagarmid , ihab f. ilyas COL venue VAL vldb COL year VAL 2003	COL title VAL relational databases for querying xml documents : limitations and opportunities COL authors VAL jayavel shanmugasundaram , kristin tufte , chun zhang , gang he , david j. dewitt , jeffrey f. naughton COL venue VAL very large data bases COL year VAL 1999	0
COL title VAL extraction of object-oriented structures from existing relational databases COL authors VAL julia e. hodges , shekar ramanathan COL venue VAL sigmod record COL year VAL 1997	COL title VAL accessing a relational database through an object-oriented database interface COL authors VAL jack a. orenstein , d. n. kamber COL venue VAL very large data bases COL year VAL 1995	0
COL title VAL active views for electronic commerce COL authors VAL laurent mignet , serge abiteboul , tova milo , adi eyal , bernd amann , sophie cluet COL venue VAL vldb COL year VAL 1999	COL title VAL active views for electronic commerce COL authors VAL serge abiteboul , bernd amann , sophie cluet , adi eyal , laurent mignet , tova milo COL venue VAL very large data bases COL year VAL 1999	1
COL title VAL optimizing queries with universal quantification in object-oriented and object-relational databases COL authors VAL guido moerkotte , jens claußen , klaus peithner , alfons kemper COL venue VAL vldb COL year VAL 1997	COL title VAL relational databases for querying xml documents : limitations and opportunities COL authors VAL jayavel shanmugasundaram , kristin tufte , chun zhang , gang he , david j. dewitt , jeffrey f. naughton COL venue VAL very large data bases COL year VAL 1999	0
COL title VAL static detection of security flaws in object-oriented databases COL authors VAL keishi tajima COL venue VAL sigmod conference COL year VAL 1996	COL title VAL repositories and object oriented databases COL authors VAL philip a. bernstein COL venue VAL acm sigmod record COL year VAL 1998	0
COL title VAL on-line reorganization in object databases COL authors VAL s. sudarshan , rajeev rastogi , s. seshadri , mohana krishna lakhamraju COL venue VAL sigmod conference COL year VAL 2000	COL title VAL static detection of security flaws in object-oriented databases COL authors VAL keishi tajima COL venue VAL international conference on management of data COL year VAL 1996	0
COL title VAL cure : an efficient clustering algorithm for large databases COL authors VAL sudipto guha , rajeev rastogi , kyuseok shim COL venue VAL sigmod conference COL year VAL 1998	COL title VAL efficient and effective clustering methods for spatial data mining COL authors VAL raymond t. ng , jiawei han COL venue VAL very large data bases COL year VAL 1994	0
COL title VAL ensuring relaxed atomicity for flexible transactions in multidatabase systems COL authors VAL bharat k. bhargava , aidong zhang , marian h. nodine , omran a. bukhres COL venue VAL sigmod conference COL year VAL 1994	COL title VAL olap , relational , and multidimensional database systems COL authors VAL george colliat COL venue VAL acm sigmod record COL year VAL 1996	0
COL title VAL secure transaction processing in firm real-time database systems COL authors VAL binto george , jayant r. haritsa COL venue VAL sigmod conference COL year VAL 1997	COL title VAL transaction timestamping in ( temporal ) databases COL authors VAL christian s. jensen , david b. lomet COL venue VAL very large data bases COL year VAL 2001	0
COL title VAL book review column COL authors VAL karl aberer COL venue VAL sigmod record COL year VAL 2002	COL title VAL book review column COL authors VAL karl aberer COL venue VAL acm sigmod record COL year VAL 2003	0
COL title VAL discover : keyword search in relational databases COL authors VAL vagelis hristidis , yannis papakonstantinou COL venue VAL vldb COL year VAL 2002	COL title VAL dbxplorer : enabling keyword search over relational databases COL authors VAL sanjay agrawal , surajit chaudhuri , gautam das COL venue VAL international conference on management of data COL year VAL 2002	0
COL title VAL deeds towards a distributed and active real-time database system COL authors VAL joakim eriksson , jonas mellin , sten andler , mikael berndtsson , bengt eftring , jörgen hansson COL venue VAL sigmod record COL year VAL 1996	COL title VAL secure buffering in firm real-time database systems COL authors VAL binto george , jayant r. haritsa COL venue VAL very large data bases COL year VAL 1998	0
COL title VAL a compact b-tree COL authors VAL ivan t. bowman , peter bumbulis COL venue VAL sigmod conference COL year VAL 2002	COL title VAL a compact b-tree COL authors VAL peter bumbulis , ivan t. bowman COL venue VAL international conference on management of data COL year VAL 2002	1
COL title VAL the persistent cache : improving oid indexing in temporal object-oriented database systems COL authors VAL kjetil nørvåg COL venue VAL vldb COL year VAL 1999	COL title VAL the ccube constraint object-oriented database system COL authors VAL alexander brodsky , victor e. segal , jia chen , paval a. exarkhopoulo COL venue VAL international conference on management of data COL year VAL 1999	0
COL title VAL metadata for integrating speech documents in a text retrieval system COL authors VAL martin wechsler , ulrike glavitsch , peter schäuble COL venue VAL sigmod record COL year VAL 1994	COL title VAL integrating contents and structure in text retrieval COL authors VAL ricardo baeza-yates , gonzalo navarro COL venue VAL acm sigmod record COL year VAL 1996	0
COL title VAL automatic discovery of language models for text databases COL authors VAL aiqun du , james p. callan , margaret e. connell COL venue VAL sigmod conference COL year VAL 1999	COL title VAL models and languages for describing and discovering e-services COL authors VAL fabio casati , ming-chien shan COL venue VAL international conference on management of data COL year VAL 2001	0
COL title VAL book review column COL authors VAL karl aberer COL venue VAL sigmod record COL year VAL 2003	COL title VAL book review column COL authors VAL karl aberer COL venue VAL acm sigmod record COL year VAL 2003	0
COL title VAL database research : achievements and opportunities into the 21st century COL authors VAL jeffrey d. ullman , abraham silberschatz , michael stonebraker COL venue VAL sigmod record COL year VAL 1996	COL title VAL database research : achievements and opportunities into the 1st century COL authors VAL avi silberschatz , mike stonebraker , jeff ullman COL venue VAL acm sigmod record COL year VAL 1996	1
COL title VAL cost based query scrambling for initial delays COL authors VAL tolga urhan , michael j. franklin , laurent amsaleg COL venue VAL sigmod conference COL year VAL 1998	COL title VAL cost-based query scrambling for initial delays COL authors VAL tolga urhan , michael j. franklin , laurent amsaleg COL venue VAL international conference on management of data COL year VAL 1998	1
COL title VAL continuous queries over data streams COL authors VAL jennifer widom , shivnath babu COL venue VAL sigmod record COL year VAL 2001	COL title VAL processing set expressions over continuous update streams COL authors VAL sumit ganguly , minos garofalakis , rajeev rastogi COL venue VAL international conference on management of data COL year VAL 2003	0
COL title VAL object fusion in mediator systems COL authors VAL yannis papakonstantinou , hector garcia-molina , serge abiteboul COL venue VAL vldb COL year VAL 1996	COL title VAL query caching and optimization in distributed mediator systems COL authors VAL s. adali , k. s. candan , y. papakonstantinou , v. s. subrahmanian COL venue VAL international conference on management of data COL year VAL 1996	0
COL title VAL repositories and object oriented databases COL authors VAL philip a. bernstein COL venue VAL sigmod record COL year VAL 1998	COL title VAL odefs : a file system interface to an object-oriented database COL authors VAL narain h. gehani , h. v. jagadish , william d. roome COL venue VAL very large data bases COL year VAL 1994	0
COL title VAL query optimization for selections using bitmaps COL authors VAL ming-chuan wu COL venue VAL sigmod conference COL year VAL 1999	COL title VAL including group-by in query optimization COL authors VAL surajit chaudhuri , kyuseok shim COL venue VAL very large data bases COL year VAL 1994	0
COL title VAL wrapping web data into xml COL authors VAL david buttler , wei han , calton pu COL venue VAL sigmod record COL year VAL 2001	COL title VAL wrapping web data into xml COL authors VAL wei han , david buttler , calton pu COL venue VAL acm sigmod record COL year VAL 2001	1
COL title VAL concurrency control in hierarchical multidatabase systems COL authors VAL henry f. korth , abraham silberschatz , sharad mehrotra COL venue VAL vldb j. COL year VAL 1997	COL title VAL an aspect of query optimization in multidatabase systems COL authors VAL chiang lee , chia-jung chen , hongjun lu COL venue VAL acm sigmod record COL year VAL 1995	0
COL title VAL data grid management systems COL authors VAL arun jagatheesan , arcot rajasekar COL venue VAL sigmod conference COL year VAL 2003	COL title VAL database systems management and oracle8 COL authors VAL c. gregory doherty COL venue VAL international conference on management of data COL year VAL 1998	0
